#Ukrainian
Back=Назад
BackBig=НАЗАД
Close=Закрити
CloseBig=ЗАКРИТИ
Upgrade=Покращити
UpgradeBig=ПОКРАЩИТИ
MissionFailedTitle=МІСІЯ НЕ ВИКОНАНА!
MissionCompletedTitle=МІСІЯ ВИКОНАНА!
VictoryTitle=ПЕРЕМОГА
DefeatTitle=ПОРАЗКА
Unlocked=РОЗБЛОК.
SelectLangTitle=Оберіть мову:
Reward=Нагорода
or=або
Loading=ЗАВАНТАЖЕННЯ: {0}%
StartGame=ПОЧАТИ ГРУ
3DSampleLevel=3D РІВЕНЬ (ВИД ЗВЕРХУ-ЗБОКУ)
TicTacToe=ХРЕСТИКИ-НУЛИКИ vs PERCEPTRON
DuelLevel=ДУЕЛЬ проти НЕЙРОМЕРЕЖІ
RandEventTest=Тест випадкової події ({0}%)
Fail=Невдача
Success=Успіх!
Attempt=Спроба {0}
DuelGameTitle=Дуель кіборгів
DuelGameDescription=Це покрокова дуель, твій хід перший! Знищи свого опонента раніше, ніж він знищить тебе!
DuelIntroDialogMsg=Ти той герой, який зможе мене перемогти?! Побачимо, чи вийде!
DuelIntroDialogOption1=Готуйся до бою!
Settings=Налаштування
Language=Мова
QuestCompleteDesc=Завдання "{0}" виконано!
QuestComplete=Завдання виконано
TestQuest=Переможець
Play=Грати
PressAnyKey=Натисни будь-яку клавішу, щоб продовжити